###################
#.................#
#.........#.......#
#.....#....#......#
#..........#......#
#..........#......#
#..........#G.....#
#..........#......#
#..........#......#
#..........#......#
###################